wt,wt,wt,wt,wt,wt,wt,wt,wt,wt
wt,sp,ft,ft,ft,ft,ft,ft,sp,wt
wt,ft,wt,wt,wt,wt,wt,wt,ft,wt
wt,ft,ft,ft,ft,ft,ft,wt,ft,wt
wt,ft,ft,ft,ft,ft,ft,wt,ft,wt
wt,ft,ft,ft,ft,ft,ft,wt,ft,wt
wt,sp,ft,ft,ft,ft,ft,ft,sp,wt
wt,wt,wt,wt,wt,wt,wt,wt,wt,wt