wt,wt,wt,wt,wt,wt,wt,wt,wt,wt,wt,wt,wt,wt,wt,wt,wt,wt,wt,wt
wt,sp,wt,ft,ft,ft,ft,ft,ft,ft,ft,ft,ft,ft,ft,ft,ft,ft,ft,wt
wt,ft,wt,ft,ft,ft,ft,wt,ft,wt,ft,ft,sp,wt,ft,ft,ft,ft,ft,wt
wt,ft,wt,ft,ft,ft,ft,ft,ft,wt,wt,wt,wt,ft,ft,ft,ft,ft,ft,wt
wt,ft,wt,wt,wt,wt,wt,ft,ft,wt,ft,ft,wt,ft,ft,ft,ft,ft,ft,wt
wt,ft,ft,ft,ft,ft,ft,ft,ft,ft,ft,ft,wt,ft,ft,ft,ft,ft,ft,wt
wt,ft,wt,ft,ft,ft,ft,ft,wt,ft,ft,ft,wt,sp,ft,ft,ft,ft,ft,wt
wt,ft,ft,ft,sp,ft,ft,ft,ft,ft,ft,ft,ft,ft,ft,ft,ft,ft,ft,wt
wt,wt,wt,wt,wt,wt,wt,wt,wt,wt,wt,wt,wt,wt,wt,wt,wt,wt,wt,wt