wt,wt,wt,wt,wt,wt,wt,wt,wt,wt
wt,ft,ft,ft,ft,ft,ft,ft,ft,wt
wt,ft,wt,wt,wt,wt,wt,wt,ft,wt
wt,ft,ft,ft,ft,ft,ft,ft,ft,wt
wt,ft,ft,ft,ft,ft,ft,ft,ft,wt
wt,wt,wt,wt,wt,wt,wt,wt,wt,wt