wt,wt,wt,wt,wt,wt,wt,wt,wt,wt
wt,sp,ft,ft,ft,ft,ft,ft,ft,wt
wt,ft,wt,wt,wt,wt,wt,wt,ft,wt
wt,ft,ft,ft,ft,ft,sp,ft,ft,wt
wt,ft,ft,ft,ft,ft,ft,ft,ft,wt
wt,wt,wt,wt,wt,wt,wt,wt,wt,wt